ESNT - Selección Nacional
ESAE - Albacete
ESAL - Almería
ESAB - Athletic Bilbao
ESAM - Atlético de Madrid
ESBA - Barcelona
ESCA - Cádiz
ESCR - Cartagena
ESCE - Celta de Vigo
ESDA - Deportivo Alavés
ESDC - Deportivo la Coruña
ESEL - Elche
ESES - Espanyol
ESGI - Girona
ESGR - Granada
ESLE - Leganés
ESMA - Málaga
ESML - Mallorca
ESOS - Osasuna
ESRA - Rayo Vallecano
ESRB - Real Betis
ESRM - Real Madrid
ESRO - Real Oviedo
ESRS - Real Sociedad
ESRV - Real Valladolid
ESRZ - Real Zaragoza
ESSE - Sevilla
ESSG - Sporting Gijón
ESTE - Tenerife
ESLP - Las Palmas
ESVA - Valencia
ESVI - Villareal