ENNT - Selecci√≥n Nacional
ENAR - Arsenal
ENAV - Aston Villa
ENBI - Birmingham City
ENBR - Blackburn Rovers
ENBL - Blackpool
ENBO - Bournemouth
ENBH - Brighton and Hove Albion
ENBT - Bristol City
ENCA - Cardiff City
ENCH - Chelsea
ENCO - Coventry City
ENCR - Crystal Palace
ENEV - Everton
ENFU - Fulham
ENHU - Hull City
ENLD - Leeds United
ENLE - Leicester City
ENLI - Liverpool
ENMC - Manchester City
ENMU - Manchester United
ENMD - Middlesbrough
ENML - Millwall
ENNU - Newcastle United
ENNW - Norwich City
ENNF - Nottingham Forest
ENQP - Queens Park Rangers
ENSH - Sheffield United
ENSO - Southampton
ENST - Stoke City
ENSU - Sunderland
ENSW - Swansea City
ENTO - Tottenham Hotspur
ENWA - Watford
ENWB - West Bromwich Albion
ENWH - West Ham United
ENWO - Wolverhampton Wanderers